########################################
#GGGGG#GGGGGGGGGGGGGGG#GGGGGGGGGGGGGGGG#
#GGGGGGGGGGGGGGGGGGGGGGGGGGGGGGGGGGGGGG#
#GGGGG#GGGGGGGGGGGGGGG#GGGGGGGGGGGGGGGG#
#GGGGG###GG#GG###GGGGGGGGGGGGGGGGGGGGGG#
#GGGG##GGGGGGGGG#GGGGG#GGGGGGGGGGGGGGGG#
#GGGGGGGGGG1GGGG#GGGGGGGGGGGGGGGGGGGGGG#
#GGGGGGGGGGGGGGG#GGGGG#GGGGGGGGGGGGGGGG#
#GGGG##GGGGGGGGG#GGGGGGGGGGGGGGGGGGGGGG#
#GGGGG###GG#GG###GGGGG#GGGGGGGGGGGGGGGG#
#GGGGG#GGGGGGGGGGGGGGGGGGGGGGGGGGGGGGGG#
#GGGGG#GGGGGGGGGGGGGGG#GGGGGGGGGGGGGGGG#
#GGGGG#################GGGGGGGGGGGGGGGG#
#GGGGGGGGGGGGGGGGGGGGGGGGGGGGGGGGGGGGGG#
#GGGGGGGGGGGGGGGGGGGGGGGGGGGGGGGGGGGGGG#
#GGGGGGGGGGGGGGGGGGGGGGGGGGGGGGGGGGGGGG#
#GGGGGGGGGGGGGGGGGGGGGGGGGGGGGGGGGGGGGG#
#GGGGGGGGGGGGGGGGGGGGGGGGGGGGGGGGGGGGGG#
#GGGGGGGGGGGGGGGGGGGGGGGGGGGGGGGGGGGGGG#
#GGGGGGGGGGGGGGGGGGGGGGGGGGGGGGGGGGGGGG#
#GGGGGGGGGGGGGGGGGGGGGGGGGGGGGGGGGGGGGG#
#GGGGGGGGGGGGGGGGGGGGGGGGGGGGGGGGGGGGGG#
########################################
